detached	detached
portugese	portugese
have	have	hae	hav	haeg	hev
accustomed	accustomed
resurrection	resurrection
ubiquitous	ubiquitous
tornados	tornados
detailed	detailed
exploitative	exploitative
attributes	attributes	tributes
parenthesis	parenthesis
repetition	repetition
villian	villian
supplanted	supplanted
roomate	roomate
occassionally	occassionally
opression	opression
manufacture	manufacture
exacerbated	exacerbated	exerted	enervated
cervical	cervical
usually	usually	usual
heros	heros
commemorative	commemorative
famous	famous
successfull	successfull
dimensions	dimensions
thru	thru
superceded	superceded
the	the	then	tone	tune	tyne	thee	thune	tine	thane	thine	ohne	tane	thre	thie	thye	tne	thse	thn	thae
resident	resident
mediterranean	mediterranean
rediculous	rediculous
electricty	electricty
parent	parent	apparent
sparingly	sparingly	disarmingly	disparagingly	despairingly	dismayingly	unsparingly
insistance	insistance
libel	libel	lidell	hibell	lubell	libels
absorbed	absorbed
precursor	precursor
archaeology	archaeology	archeology
whic	whic
efficiently	efficiently
now	now	know	ekow	kow
mysterious	mysterious
decribed	decribed
behaviour	behaviour
occured	occured
innumerable	innumerable
alledged	alledged
similar	similar
with	with	wit	wight	witt	wilt	iht	whit	wirt	wint	wih	waht	wht
concentrate	concentrate
about	about	bout	saout
ninth	ninth	ninety
deviated	deviated
alcoholic	alcoholic	alcoholics
negligible	negligible
attempted	attempted	attested	attemped
imagine	imagine	imaging	imagi	imagen
carnivorous	carnivorous
idea	idea	ideas	idsa	ides	desa
rhythm	rhythm
phillipines	phillipines
accomplishments	accomplishments
surprised	surprised
religious	religious	religous
forbid	forbid	forbade
guaranteed	guaranteed
repentant	repentant
misdemeanor	misdemeanor
consitution	consitution
specify	specify	specie
independently	independently
descendent	descendent
allege	allege	arledge	elledge	alledged
desireable	desireable
rule	rule	rolle	tulle	ruble	bulle
refered	refered
stiles	stiles	stills	stilts	stylus
sargent	sargent	sargeant	sergant
deciduous	deciduous
satellites	satellites	satelite
deciphered	deciphered
subsidiary	subsidiary
working	working	woking	broking
succeeded	succeeded
guidance	guidance
dispensed	dispensed
first	first	firms	fires	fits	firth	fists	firsts	forts	flirts	firs	frits	farts	firas	fiats	virts	fitts
interrupt	interrupt
enviromental	enviromental
practical	practical	practically
finaly	finaly
with	with	wth	ith
powerfull	powerfull
not	not	into	knot	pinot	int	minot	snot	inet	ino	ingot	inox	inoc	inoa	ibot
colouration	colouration
accomodate	accomodate
covered	covered	converted	coveted
promiscuous	promiscuous
worsened	worsened
reached	reached	teacher	teaches	beached	leached	teched	teache
reconcilation	reconcilation
imminent	imminent	eminent
annulled	annulled
incorporation	incorporation
doub	doub
emission	emission	emilion	elision
census	census	censure	censor
tyre	tyre	eyre	pyre	wyre	vere	vre	ayre	gyre	lyre	vyse	byre	vye
canonical	canonical
ceremonial	ceremonial
neighbour	neighbour
natural	natural	naturally	naturals	naturale
unecessary	unecessary
environments	environments	enviroment
that	that
performance	performance
privelege	privelege
inappropriate	inappropriate
liason	liason
environmentally	environmentally
takes	takes
encryption	encryption
heritage	heritage	inheritance	inheritable
genealogies	genealogies
efficiently	efficiently
conditions	conditions
mentioned	mentioned	maintained
exalted	exalted	exhaled
write	write	wrist	writ	triet
annointed	annointed
formalized	formalized
misdemeanors	misdemeanors
demeanor	demeanor	dampener	damer	deminor	damen	samenow
commonly	commonly
time	time	thome	tome	tiote	biome	toome
proprietary	proprietary
accused	accused	accessed	accursed
occassion	occassion
instance	instance	insistance
prominent	prominent
predominately	predominately
license	license	hisense
exempt	exempt
login	login	goggin	goin	godin	gorin	golin	gogii	gobin	rogin
heterogeneous	heterogeneous
decision	decision
engineering	engineering	engendering
criticisms	criticisms	criticises
originally	originally	orginally
remembrance	remembrance
withdrawl	withdrawl
notoriety	notoriety
primordial	primordial
breakthough	breakthough
these	these	cheese	therese	teese
assassinate	assassinate	assasinated
dissolved	dissolved
constantly	constantly	constancy
this	this	things	thing	thin	thigh	thugs	thirst	thighs	twigs	thigpen	thilan	thirsk	higson	thins	thion	whigs	thies	thien	teigen	teign	tigon
always	always	alway
volunteered	volunteered
adaption	adaption
cant	cant
wierd	wierd
simpler	simpler
sieze	sieze
specialized	specialized
strictest	strictest
probability	probability
occurrences	occurrences
idiosyncratic	idiosyncratic
contributers	contributers
make	make	mae
stores	stores	stories	storeys
controversial	controversial
tolerance	tolerance
subtracted	subtracted
fascinated	fascinated
admissable	admissable
receivers	receivers	relievers	recieves
philosopher	philosopher
ascetic	ascetic	aseptic	acetic
tommorrow	tommorrow
reconnaissance	reconnaissance
taking	taking	kaing
aspects	aspects	sects	specs	specks	spect
succesfully	succesfully	sucessfully
maintainence	maintainence
suppressing	suppressing
vegetables	vegetables
personel	personel
transmissible	transmissible
difficulties	difficulties
active	active	achieve	archive	chive	acheive
commited	commited
sound	sound
perjury	perjury
possess	possess	possesses
receipt	receipt
became	became
immigration	immigration	migration	emigration
indisputably	indisputably
archaeology	archaeology
alleges	alleges	alledged
seceded	seceded
agression	agression
unsucesfuly	unsucesfuly
guttural	guttural
imitate	imitate
already	already
scaleable	scaleable
irregardless	irregardless
occasional	occasional
proceeding	proceeding	preceding
unilateral	unilateral
arbitrary	arbitrary
upon	upon	avon	aon	akon	apron	aron	alon	aptn	apos	apo	amon	aeon	axon	apoe	anon	capon	agon	pon	afon	gpon	aton	kapon	spon	apob	papon	aion	acon	adon
same	same	mae	sae	sme	sma	smar	smal	smap	smale	shae	smee	smac
shouldn	shouldn	shoudl
murdering	murdering
volunteering	volunteering
stories	stories
edition	edition	emotion	emilion
efficient	efficient	effient
know	know	nwo	kno
interrelated	interrelated
flemish	flemish	blemish
eight	eight	eighth
guanine	guanine
sidereal	sidereal
uncertainty	uncertainty
vomiting	vomiting	omitting	smiting
shouldn	shouldn	shoudl
expel	expel	expels	excell	extell
seperate	seperate
decide	decide	device	divide	devise	devine	deride	davide
died	died	idea	die	diet	dies	diva	dea	iea	dina	dia	diem	dita	dida	diya	diaa	dima	disa	dieu	dhea	diez	diep	diena	drea	dien	tiea	niea	dmea	deia	aiea
persuing	persuing
analagous	analagous
civilian	civilian
talked	talked
colonies	colonies	collonges
indulge	indulge
allege	allege	alegre	alge	aleve	aleg	alere
iconoclastic	iconoclastic
catagory	catagory
vengeance	vengeance	vengence
accommodates	accommodates	accomodate
omission	omission
example	example
maneuver	maneuver
achievements	achievements	acheivement
tenable	tenable	tentacle
myself	myself
aspects	aspects	sects	specs	specks	spect
exacerbate	exacerbate	exaggerate
mathematician	mathematician
mathematicians	mathematicians
universities	universities
wednesday	wednesday	wendy	weekday	newsday	wedneday	wensley	wenda
campain	campain
maneuverability	maneuverability	manoeuvrability
adoptions	adoptions	adaption
described	described
aquired	aquired
church	church	lurch	burch	murch	curci	curth	durch
cannisters	cannisters
ahve	ahve
describe	describe
miranda	miranda	veranda
developement	developement
imminent	imminent	eminent
sidereal	sidereal
deal	deal	del	dale	duel	gael	dahl	adel	dal	dae	cael	dail	wael	dall	yael	kael	daul	rael	lael	doel	daei	jael	daep	danel	darel	daal	deel
definetly	definetly
occasioned	occasioned
prosocial	prosocial
two	two	won	town	twin	ton	kwon	tron	toon	twos	thon	iwon	tion	gwon
levitates	levitates
goverment	goverment
criticizes	criticizes	critisize
excerpts	excerpts	exerts	exempts
philosophy	philosophy
candidate	candidate
publically	publically
disapproval	disapproval
year	year	years	yeast	yeas
advice	advice	advised	advices
maneuver	maneuver
could	could	coull	woudl
opponent	opponent
villain	villain	violin	millin	killin	villian	villi	villis
adoptive	adoptive
recommend	recommend
was	was	wis	wes	wsj	nws	wcs	wsu	wps	cws	mws	aws	wls	kws	wsi	wsb	vws	wms	wsp	sws	rws	wsl	gws	dws	bws	wrs	wns	wsc	pws	fws	wgs	uws	wsr	wbs	lws	ews	wus	wds	wse	whs	wsf	wsa	wst	wsm	wsh	wsg
calculate	calculate
butts	butts	abuts
geologist	geologist	theologian	ideologist	ethnologist
misdemeanor	misdemeanor
catholic	catholic
emitted	emitted
learn	learn	lean	levan	lerman	eran	loran	leman	keran	beran	lehan	lera	veran
achievement	achievement	achievments
troups	troups
benifit	benifit
symmetrical	symmetrical	symmetrically
corresponding	corresponding
maneuvers	maneuvers
things	things	thighs	thins
construction	construction
artical	artical
commissions	commissions	omissions	comission
annual	annual	manual	anal	andal	anfal	antal	anuak
pastoral	pastoral	postural
sufficiently	sufficiently
threshhold	threshhold
levitating	levitating
judaism	judaism
immigrant	immigrant	migrant	emigrant
wass	wass
medicine	medicine	medecine
commiting	commiting
wintery	wintery
singsong	singsong
claims	claims	claimed	climes	claimer
license	license	hisense
harrassing	harrassing
unconcious	unconcious
siezed	siezed
turn	turn	turns	trunk	turk	turok	turek
decisions	decisions
detrimental	detrimental
maneuver	maneuver
restaurant	restaurant	restraint
colony	colony
neice	neice
moment	moment	mount	mont	monet	moen	moet	ment
poem	poem	prom	perm	pom	peo	pem	peon	peos	poom	petm	eom
for	for	four	form	fomc	foer	fom	fmr	fomer
assasinated	assasinated
some	some	seem	stem	poem	oem	soe	siem	som	sem	soes	soep	noem
address	address	andres	adores	adders
comittee	comittee
reminiscent	reminiscent
realized	realized	relied	relived	resized
campaigns	campaigns	campain	campaing
concern	concern
independent	independent
describing	describing
disobedient	disobedient
since	since	sine	sione	signe
bestiality	bestiality
cartridge	cartridge
airbourne	airbourne
fundamentals	fundamentals
formalize	formalize
attendants	attendants
desperation	desperation	respiration
lively	lively	lilley	linley	likley
negligible	negligible	legible	negligee
parallel	parallel	farrall	paracel
archaeologists	archaeologists	archeologists
shouldnt	shouldnt
integrated	integrated
commissions	commissions	collisions	omissions	commision	dominions	comission
restraint	restraint
exempt	exempt	exert	excerpt
elicited	elicited
professor	professor	proffer	proffers
elephant	elephant
arbitrarily	arbitrarily
using	using	sueing
metalurgic	metalurgic
phenomenon	phenomenon	phenomenally	phenomenons
proclamation	proclamation
volunteer	volunteer
rococo	rococo
unsurprised	unsurprised
genealogy	genealogy
comission	comission
used	used	unused	unwed	unser	unseld	unfed
programs	programs	pogroms
guard	guard	gourd	gard	gaur	gauri	gaura
privledge	privledge
going	going	goin	goian
obstacle	obstacle
proceed	proceed	precede
effort	effort	afford
premiere	premiere
field	field	feels	fields	files	fuels	fills	niels	fils	fels	fiefs	fies
regular	regular
surprising	surprising
profession	profession	profusion
intuitive	intuitive
exciting	exciting	limiting	editing	vomiting	exiting	emitting	emailing	emoting	commiting	meriting	smiting	summiting
obedience	obedience
pinnacle	pinnacle
hfea	hfea	hea	hve	vea	svea
independence	independence
womens	womens
bible	bible	liable	libel	lille	libre	lisle	litle	wible	lidle	lable
beacuse	beacuse
plaintiff	plaintiff
archetype	archetype
playwrites	playwrites
wrote	wrote	wroe
ocurred	ocurred
back	back	beak	bca	bak	cak	bcap
saturday	saturday	waterway	latterday	esterday	easterday
really	really	relay	realy
disobedience	disobedience
collectable	collectable
overshadowed	overshadowed
naturel	naturel	maturely
controll	controll
constituency	constituency
possessed	possessed
calculated	calculated
layed	layed
heritage	heritage	inheritance	inheritable
orginal	orginal
those	those	ethos
separating	separating
stringent	stringent
amoung	amoung
noone	noone
illegitimate	illegitimate
lief	lief
election	election	electron	elector
manufacturing	manufacturing
useable	useable
working	working	woking	worring
midwives	midwives	midwife	midwifed
casualty	casualty
woudl	woudl
boat	boat	bout	boast	bogut	borut	boalt	beaut
attendant	attendant
vigour	vigour	rigeur	viveur
offical	offical
likelyhood	likelyhood
parallel	parallel
record	record
usually	usually	sally
targetted	targetted
original	original
writen	writen
limited	limited	excited	edited	emptied	emitted	exited	emailed	merited	vomited	emmitt	commited	summited	admited	emmie	emoted
contemporaries	contemporaries
transcending	transcending
make	make	ame	ake	amie	anke	aske	amte	kamke	famke
phenomenon	phenomenon	phenomenally	phenomenons
miniscule	miniscule
whereever	whereever
harrises	harrises	harrass
syria	syria	mbia	lydia	bia	tibia	sybil	nydia	fabia	rabia	ayia	sabia	labia	ryba	kobia	yba	nubia	cydia	olbia	abia	hybla	tobia
developed	developed
consider	consider
correspondents	correspondents	correspondant
surveyed	surveyed	surveyor
intellectual	intellectual
surrounded	surrounded
rela	rela
choosen	choosen
thinks	thinks	thins
maintenance	maintenance	raindance
criticized	criticized	critisize
remeber	remeber
allone	allone	allibone
provision	provision	improvisation	improvising	imprecision	microvision
waterways	waterways	saturdays
annihilation	annihilation
year	year	ear	yar	exar	eyal	kyar	eyak	eyad	eyam	eya	ayar
efford	efford
agreeing	agreeing	ageing
russia	russia	russian	mussina
dieing	dieing
commander	commander	colander
regularly	regularly
ideologies	ideologies	idealogues
appreciate	appreciate
acheivement	acheivement
irresistable	irresistable
throught	throught
symmetrically	symmetrically
caterpillar	caterpillar
benifits	benifits
dispensing	dispensing
efford	efford
cartilage	cartilage
advertisment	advertisment
comparision	comparision
environmental	environmental
permenant	permenant
throught	throught
device	device	divide	divine
century	century	centrum
amend	amend
practitioners	practitioners
considered	considered	consider	considers
psychology	psychology
besieging	besieging
adopt	adopt
commissioned	commissioned
commercially	commercially
cartlidge	cartlidge
will	will	willl
obedient	obedient
terrorist	terrorist	territories	territorial
archaeologist	archaeologist	archeologist
thinking	thinking	thinning
wanted	wanted
idealogy	idealogy
disappears	disappears
learn	learn	lean	leaner	lear	leans	leann	leant	leang	leane
preamble	preamble
demeanor	demeanor	deminor
stange	stange
immigrant	immigrant	migrant	emigrant
discover	discover
probably	probably
targetting	targetting
massachussetts	massachussetts
irresistibly	irresistibly	irresistable
acquires	acquires
acquaintances	acquaintances
commisioner	commisioner
sacrafice	sacrafice
original	original	originally	originals
flourish	flourish
cant	cant
swear	swear	skaer	shaer	snaer
misogynist	misogynist
reconnaissance	reconnaissance
russian	russian	mission	session	passion	cushion	fusion	fission	busson	hession	suasion	musson	hussien	husson
corresponds	corresponds
disappeared	disappeared
governmental	governmental
caught	caught	fought	taught	fraught	naught	vaught	aught
efforts	efforts	affords	efford	jeffords
representatives	representatives
imminent	imminent	eminent	manet	tranent	imagen
pususading	pususading
algorithms	algorithms
divison	divison
persue	persue
accession	accession	ascension
interregnum	interregnum
when	when	wen	wean	rehn	wein	ween	wern	dehn	wenn	behn	kehn	wehr	fehn
grammer	grammer
rigourous	rigourous
occasionally	occasionally
misdemeanors	misdemeanors
municipalities	municipalities
great	great	grant	greet	graft	grate	grael	graef	graetz	granet
gasses	gasses
polite	polite	pollute
linguistic	linguistic
champagne	champagne
childbirth	childbirth
recommended	recommended
recommend	recommend
corresponded	corresponded
successive	successive
aggravate	aggravate
indefinitely	indefinitely
incompatibility	incompatibility
maneuverability	maneuverability
basically	basically
omnivorous	omnivorous
persistence	persistence
attainder	attainder
chemistry	chemistry
rhythm	rhythm
monasteries	monasteries
strengthened	strengthened
afficionados	afficionados
boundary	boundary
criterion	criterion
neighbouring	neighbouring
competence	competence
whole	whole	wohl	wole	dohle	wehle	hohle	worle	wahle	ohle	bohle
rhythm	rhythm
work	work	wok	rok	wroe	wook	brok
constitutional	constitutional
missed	missed	misses	nissen	meissen	missan	misson
ironically	ironically	ironic	ironical
persuaded	persuaded
mroe	mroe
assasination	assasination
misogyny	misogyny
artifical	artifical
decomposing	decomposing	decomposed	decompose	decomposes
demeanor	demeanor	dampener	damer	deminor	damen	samenow
miles	miles	mile	miley	milieu	miler
them	them	rather	rhythm	anthem	lytham	rother	hythe	rothen	wythe	lethem	rotem	rothes	sytem	erythema	ryohei	rathe	rothe	mythe
study	study	sturdy	studly	studd	studds
strenuous	strenuous
sponsor	sponsor	spenser
independently	independently
conquered	conquered	conqueror
lieutenant	lieutenant
that	that	tata	tha	hta	thea	theta	tht	tita	teta	thua
lindsay	lindsay	wendy	wends	lyndsay	wenda	wednesay
clearly	clearly
agressively	agressively
collosal	collosal
electrical	electrical
paraphernalia	paraphernalia
maneuvers	maneuvers
enlargement	enlargement
calender	calender
received	received	relieved	relived	beleived
cost	cost	coast	cast	caos
propoganda	propoganda
impeach	impeach
councillor	councillor	counsellor
reknowned	reknowned
diferent	diferent
recieves	recieves
strived	strived
seizure	seizure
realized	realized	relied	relived	resized
parallel	parallel	parallels
languages	languages
subtracts	subtracts
becuase	becuase
greif	greif
seizing	seizing	sizing	sieving
those	those	ethos
signatory	signatory
signatories	signatories
commemorated	commemorated
university	university	univerity
optimism	optimism
occassional	occassional
soverign	soverign
leisure	leisure
satellites	satellites	satelite	seattleites
miscellaneous	miscellaneous
metallurgical	metallurgical
liquefy	liquefy
involvment	involvment
satyr	satyr	soter
essential	essential
programmable	programmable
show	show	soho	sow	sohn	sohu	soh	sohl	shw	soha
becasue	becasue
easily	easily	basic	basically	basics	basil	busily	vasily	basile	baily	bailly	basili
dessicated	dessicated
wife	wife	wie	wef	wilf	wien	fief	ief	lief	wiel
volunteers	volunteers
says	says	seas	sas	spas	saas	shas	sfas	yas	dyas	syms	byas	soas	sys	slas	vyas	syal	stas	ssas
appealing	appealing	appalling
decomposed	decomposed
transcendence	transcendence
resemblence	resemblence
cassawory	cassawory
nto	nto
exhibitions	exhibitions
michigan	michigan
begining	begining
buffaloes	buffaloes
successes	successes
presumably	presumably
trilogy	trilogy
innumerable	innumerable
Mohammedan	Mohammedan
fromong	fromong	pheromone
negotiation	negotiation
business	business	businesses
vaccine	vaccine	accuse	vacuum	vacuums	vacuumed
causalities	causalities
could	could	coull	woudl
found	found	foudy
essential	essential
position	position
back	back	bake	baku	bac	banc	baic	bak	bakr	bako	barc	akc	baka	baki	bkc	basc
commitee	commitee
unnecessary	unnecessary
think	think	thin	thion	thien	thika
unilaterally	unilaterally
commissioned	commissioned	commisioner
emigrated	emigrated	migrated	immigrated
strat	strat
misdemeanors	misdemeanors
upon	upon	avon	aon	akon	apron	aron	alon	aptn	apos	apo	amon	aeon	axon	apoe	anon	capon	agon	pon	afon	gpon	aton	kapon	spon	apob	papon	aion	acon	adon
quite	quite	cutie	qurie
election	election	electron	elector
irritated	irritated	imitated
irresistible	irresistible	resistible
lief	lief
response	response
florescent	florescent
beggin	beggin
simply	simply	simple	simpler	simplex	simley	simples
empirical	empirical
accomplishment	accomplishment
polution	polution
concerning	concerning	conserving
occurance	occurance
phenomenon	phenomenon
facilitated	facilitated
achievments	achievments
analytic	analytic
hypocrits	hypocrits
altough	altough
natural	natural
correspondents	correspondents	correspondant
accommodated	accommodated	accomodate
communication	communication
preferably	preferably
adressing	adressing
mature	mature	armature
decided	decided	divided	devised	derided	deviled
playwrite	playwrite
during	during	bring	buying	burning	boring	burying	luring	curing	bering	baring	busing	turing	burling	burping	burin
addressable	addressable
aeriel	aeriel
councillors	councillors	counsellors
omniverously	omniverously
innocence	innocence
determining	determining
governmental	governmental
convenient	convenient
comparative	comparative
consitutional	consitutional
invertebrates	invertebrates
irresistable	irresistable
commision	commision	comission
emmisarry	emmisarry
aquitted	aquitted
eligible	eligible
about	about	bout	saout
motivated	motivated
ghana	ghana	lhasa	hack	dhaka	shack	whack	baca	thaci	aca	ithaca	hca	shana	chara	hana	chaka	haka	hala	khama	chace	hara	graca	haha	haya	taca	thapa	hawa	chaco	chacha	haga	hama	hava	shara	chica	waca	naca	shaya	ohana	saca	shala	ahca	shaka	chana	shac	chaya	hada	thana	ahava	chac	ahaa	placa	shada	ghada	caca	shama	haa	maca	thala	ihara	chama	vaca	hcca	hacan	shaea	chapa	haza	shawa	hac	thach	hafa	laca	praca	khana	hasa	dhara	chaa	khata	chacao	ohata	haci	wahaca	shaha	hace	bhac	abaca
nouveau	nouveau
recommend	recommend
beleive	beleive
wild	wild	weird	wield	weill	weil	weld	weald	neild	feild
chairman	chairman	charman	charmian
reversible	reversible
associated	associated
judaism	judaism	sadism	dualism	nudism
averaged	averaged
acclimatization	acclimatization
quantity	quantity
constitution	constitution
copywriter	copywriter
dispelling	dispelling	misspelling	misselling
awkward	awkward	backward
english	english	polish	relish	enlist	nish	anish	elish	kalish	kulish	lish	owlish	neish	naish	mulish	fneish	delish	salish	eilish
seige	seige
countries	countries
mortgage	mortgage	mortage	morgane
monoline	monoline	monolith	moonlite
convention	convention	conventional	congenital	congenial
disappear	disappear
recipient	recipient
connotations	connotations	annotations
colonnade	colonnade
transcription	transcription	transcriptions	transcribing
statment	statment
facilitate	facilitate
personnel	personnel
critisize	critisize
administrate	administrate
perhaps	perhaps
possessing	possessing
strengthening	strengthening
discovered	discovered
ther	ther
addressable	addressable
further	further
protagonists	protagonists
resistible	resistible
the	the	tie	tee	toe	tjx	tse	tre	tae	tce	tye	tve	tue	tpe	tej	twe	tne	tbe	tjv
resurrecting	resurrecting
polluting	polluting	pouting
habitat	habitat
accomodation	accomodation
succesfully	succesfully
authobiographic	authobiographic
incredible	incredible
acquaintance	acquaintance
comming	comming
acceptable	acceptable
emitting	emitting
based	based	passed	posed	eased	paved	phased	paused	paced	pared	pasted	paled	parsed	paseo	payed	cased	paged	tased	pawed
profile	profile	profiles	prolific	profiling	profiled	profiler	profil
professor	professor
malaysian	malaysian	artesian	malthusian	cartesian	salesian	alterian
strat	strat
describes	describes
cheif	cheif
apart	apart	appert
judiciary	judiciary
recommends	recommends
spermatozoan	spermatozoan
unwieldy	unwieldy	unworldly
poems	poems	proms	poms	peons	perms	peos
admissibility	admissibility
athenian	athenian
unnecessarily	unnecessarily
vacuum	vacuum
occurrence	occurrence	occurance
oppressive	oppressive
wants	wants	nats	whats	gnats	wats	wnat
voluntary	voluntary
environments	environments	enviornment
touch	touch	torch
also	also	alot	alsop	allot
isnt	isnt
appearence	appearence
malcom	malcom
work	work	woke	wok	wor	woks	rokr
vigorous	vigorous	rigourous
levitate	levitate
performed	performed	performers	performer	performs
relevent	relevent
empirical	empirical
aggregates	aggregates
metallic	metallic
only	only	lonely	lowly	loney	lolly	lonny
with	with	wight	witt	withe	witha
very	very	grey	prey	rey	frey	trey	vre	brey	vey	vry	verey	srey	drey
genetic	genetic	poetic	frenetic	fanatic	kinetic	synetic	phonetic	jovetic	econetic	fonti	cinetic	canetic
northen	northen
actualy	actualy
edition	edition	emotion	emilion
move	move	moved	movie	moves	mover
androgynous	androgynous
commando	commando
corrosion	corrosion
rotem	rotem	protea
fundamental	fundamental
acquaintances	acquaintances
attempt	attempt	attest
deciduous	deciduous
engineer	engineer
european	european	utopian
agre	agre
accession	accession	ascension
information	information
phenomenon	phenomenon	phenomenal	phenomenons
strategy	strategy	stradey
discontentment	discontentment
admission	admission
similarly	similarly	similarity
assassins	assassins
ringing	ringing
habeus	habeus
length	length	leight
while	while	haile	wile	hile
throughly	throughly
miscellaneous	miscellaneous
distinguishing	distinguishing
appropriate	appropriate
immediately	immediately
succesful	succesful	sucessful
resembled	resembled	reassembled
transfered	transfered
posession	posession
equilibrium	equilibrium
for	for	four	form	fomc	foer	fom	fmr	fomer
harris	harris	harrah	arras	barras	marras	harran	darras	karras	harra	harrap	harrad	harrass	parras	harrar
pastime	pastime
seperated	seperated
unsuccessful	unsuccessful	unsuccessfully
introduced	introduced
extravagant	extravagant
archaeology	archaeology	archeology
used	used	unused	unwed	unser	unseld	unfed
continuing	continuing
acheivement	acheivement
primitives	primitives
unsubstantiated	unsubstantiated
privileged	privileged	privelege
strenght	strenght
calligraphy	calligraphy
english	english	polish	relish	enlist	nish	anish	elish	kalish	kulish	lish	owlish	neish	naish	mulish	fneish	delish	salish	eilish
unfortunatly	unfortunatly
mathematics	mathematics
interchangeably	interchangeably
disintegrated	disintegrated
always	always
dream	dream	dera	dram	derham	derma	derm	eram
destructive	destructive
complied	complied	complies	compiler
knows	knows	kones
supposed	supposed
casualties	casualties
business	business	businesses
deceived	deceived	recieved
confidentially	confidentially
acquired	acquired	aquired
volunteer	volunteer
happened	happened	appended
internet	internet	interpret	intervet
recreational	recreational
concentrates	concentrates
entered	entered
profession	profession	profusion
recommended	recommended
possesses	possesses
lonely	lonely	conley	loney	linley	donley	longley	loxley	monley	lynley	lobley
surroundings	surroundings
apology	apology
since	since	sense	sins	rinse	sine	sinise	singe	sines
acquainted	acquainted
oxygen	oxygen	origen	oxegen
didnt	didnt
sepulchre	sepulchre
foremost	foremost	formosa
documented	documented
addressing	addressing
hydroponic	hydroponic	hydrophobic
correspondant	correspondant
tremolo	tremolo
pilgrimage	pilgrimage
enviromental	enviromental
illegitimacy	illegitimacy
embarrasment	embarrasment
discuss	discuss
occasion	occasion	ocasio
laboratory	laboratory
coloration	coloration
cemetary	cemetary
referral	referral
terrestrial	terrestrial
anointing	anointing
industrial	industrial
cyprian	cyprian
want	want	wasn	warn	watt	wan	wat	watan	wain	wath	wats	atn	wtn	wayn	wata	wann
eliminating	eliminating
seizures	seizures
tattoos	tattoos	tattooed
portrayed	portrayed
millau	millau	mineau
circuit	circuit
money	money	moen	mony	moony	morny
massachussets	massachussets
satyr	satyr	soter
subtraction	subtraction
representative	representative	representing
address	address	andres	adores	adders
prestigious	prestigious
executed	executed
maneuverability	maneuverability
supposing	supposing
occurrence	occurrence
ficticious	ficticious
suprising	suprising
can	can	clan	chan	caan	cian	xan	cyan	coan	cran
unnecessarily	unnecessarily
habeus	habeus
admendment	admendment
councillors	councillors	counsellors
harassed	harassed
allegiance	allegiance
missle	missle
eliminated	eliminated
claim	claim	blair	blain	blais	blaid	blaum	baim	blam
confidential	confidential
dependant	dependant
missile	missile	missle	mistle
their	their	thief	thein	theis	cheif	thei
created	created
seperately	seperately
concious	concious
clearer	clearer
custom	custom	accustom
hypocrisy	hypocrisy	hypocracy
architecturally	architecturally
their	their	there	teri	cheri	sheri	ther	therm	taheri	dheri	bheri	thera	heri	jheri	thei
sould	sould
going	going	aging	owing	ogling	ging	oginga
territory	territory
commissioner	commissioner
summary	summary	sugary	sumara
electic	electic
univeristy	univeristy
canister	canister	bannister	cannisters
privileges	privileges	privelege
accomodate	accomodate
noth	noth
story	story	troy	stray	strom	stoy	stroh	strop	strey	ostroy
cooperation	cooperation
almost	almost
zionists	zionists
feasible	feasible	leasable
lava	lava	larvae	laval	lavie	lavan	lavar	lave	lavoe	lavas
persuade	persuade
constant	constant
edited	edited	emitted	exited	emoted
emigrated	emigrated	immigrated
translate	translate	translated	translates	translator
roomate	roomate
transcription	transcription	transcriptions	transcribing
visibly	visibly
distinguishes	distinguishes
subterranean	subterranean
dipthong	dipthong
licencing	licencing
conjecture	conjecture
accomplished	accomplished
restraints	restraints
cervical	cervical
acquisition	acquisition
enmity	enmity
tyranny	tyranny	tyrant
cruising	cruising	criticising	critiquing	critisize
privilege	privilege
covenant	covenant	convenants
ingredients	ingredients
Palistian	Palistian
constraints	constraints	constants
alleviate	alleviate
enamoured	enamoured
spina	spina	sepia	espina	selina	sapina	semina
pleasant	pleasant
awkward	awkward	backward
childrens	childrens
cassowarry	cassowarry
secede	secede	seceded	suceed
things	things
exaggerated	exaggerated
surreptitious	surreptitious
volunteering	volunteering
exhibition	exhibition
temperment	temperment
occurence	occurence
pich	pich
nominal	nominal
mountains	mountains	contains	fountains
comprehensive	comprehensive
wont	wont
approach	approach	approaches
compatibility	compatibility
practically	practically
britian	britian
phyllis	phyllis	syphilis
possibilty	possibilty
idea	idea	ideas	idsa	ides	desa
additionally	additionally
manufactured	manufactured
imaginary	imaginary
power	power	pwer
knowledgable	knowledgable
previous	previous
diverse	diverse	diverted	diverged
tribute	tribute	attribute
architectural	architectural
position	position	poston	positron	postion
founder	founder	runner	forerunner	brunner	fournier	fortner
majority	majority
controled	controled
petition	petition
adequate	adequate
occasioned	occasioned
mammalian	mammalian
similiar	similiar
sponsored	sponsored
embarass	embarass
demeanor	demeanor	deminor
supercede	supercede
prominently	prominently
practice	practice	practices	practical	practically	practiced
unsurprising	unsurprising
variety	variety	vanity	parity	rarity	varsity	verity	garity
sucessful	sucessful	successfull	sucessfully
consonant	consonant
grow	grow	gro
extraordinary	extraordinary
wtih	wtih
besiege	besiege	beseiged
audience	audience
resistence	resistence
commision	commision
than	than	tina	tuna	tha	tana	tna	thea	tena	thana	trna	thua	hna	thn
controversial	controversial
supposes	supposes
concept	concept	consent	consett
taxonomic	taxonomic
swears	swears	sawers
active	active	achieve	archive	chive	acheive
fled	fled	feed	fleet	freed	flee	bleed	leed	flied	flexed	flees
dissatisfaction	dissatisfaction
misdemeanor	misdemeanor
noticable	noticable
anomaly	anomaly
personel	personel
electricty	electricty
thier	thier
considered	considered
have	have	hvac	hae	hvar	hve
ninth	ninth	nifty	ninety	minty	nitty	ninoy	ninny	ginty	dinty
year	year	era	vera	dera	sera	cera	yea	gera	yer	yara	yerba	qera	hera	pera	mera	yers	eera	yura	fera	tera	aera	nera	lera	bera	kera
story	story	troy	stray	strom	stoy	stroh	strop	strey	ostroy
example	example
commercial	commercial	commerical
competion	competion
succesful	succesful	sucessful	succesfully	successfuly	sucessfully
library	library
revolutionary	revolutionary
decidely	decidely
orginal	orginal
derogatory	derogatory
what	what	wta	weta	whoa	hta	wha	whti	wata	wsta	wht
extraordinarily	extraordinarily
anoints	anoints
woudl	woudl
shoudl	shoudl
councillors	councillors	counsellors
neighbours	neighbours
agreement	agreement
quite	quite	tie	quiet	quit	tune	tube	quiz	quid	louie	que	tui	quip	cutie	qui	qurie	qube	tue	quin	tuke	quik	buie	quim	etude	quine	tule	thie	attie	quis	itune	tude	quil	quien	atie	ture
oportunity	oportunity
remembrance	remembrance
surround	surround
perceived	perceived	perfected	permeated	perverted	excepted
controversies	controversies
allegiance	allegiance	lenience
correspond	correspond
maneuvers	maneuvers
apparent	apparent
noticable	noticable
trafficked	trafficked
aviation	aviation	ovation
miscellaneous	miscellaneous
predominately	predominately
during	during	bring	buying	burning	boring	burying	luring	curing	bering	baring	busing	turing	burling	burping	burin
chemical	chemical	chemicals	chemically
athenians	athenians
beseiged	beseiged
licenced	licenced
peninsula	peninsula
pamphlet	pamphlet
bilateral	bilateral	bilaterally
acquired	acquired	acquitted
seat	seat	heat	sheet	wheat	sweat	cheat	shea	shear	sheath	sheaf	shean	shead	skeat	shat
abandon	abandon
useage	useage
which	which	hmic	wic	wisc	wich	ihc	hhc	twic	wih	uwic	hic	whic
path	path	bath	math	tata	tate	oath	tat	nath	cath	kath	hath	toth	rath	tatp	tati	wath	tash	fath	taht	ath	tatu	tato	tats	tah	lath
seperation	seperation
make	make	makes	maker	marked	naked	masked	baked	faked	raked	maxed	mated	caked	jaked	majed	miked	makem	makeda	mayed
receded	receded	preceeded	reseeded
certainty	certainty
equipment	equipment
criticized	criticized	critisize
contemporaneous	contemporaneous
puccini	puccini	vucinic	nutini	cucina	pulcini	ruini	cini	luciani	rubini	pacini	vicini	luchini
conquerors	conquerors
great	great	grant	gray	grab	rat	goat	graft	grit	gras	gran	grad	gram	graf	grate	brat	frat	grata	erat	graz	prat	gmat	gat	gnat	grau	gra	grt	grav	ghat	groat	grot	drat	gratz	arat
more	more	ore	omer	ogre	orme	emre	omri	imre	ome	ombre	mre	oare
whcih	whcih
missouri	missouri	nisour	jibouri	iouri
imaginary	imaginary
millitary	millitary
not	not	onto	knot	ono	snot	ont	oot	omot	okot
beautiful	beautiful
accompanied	accompanied
strengthen	strengthen
sovereignty	sovereignty
model	model	mode	module	mole	moyle	molde	oodle	moule	molle	moodle	odle
neighbouring	neighbouring
interbreed	interbreed	interbred
essence	essence	essenes	emsense
dramatically	dramatically	grammatically
those	those	thse
accidently	accidently
pursuit	pursuit
guiness	guiness
permission	permission	remission
organic	organic	organism	organis
payed	payed
nutrient	nutrient
characters	characters
bandwith	bandwith
perhaps	perhaps
belief	belief
useful	useful	usefully
reference	reference
erratic	erratic	erotic
imaginary	imaginary
mature	mature	armature
assassinations	assassinations	assasination
fictions	fictions	factious
forfeit	forfeit
program	program	pogrom
eminent	eminent
exoskeleton	exoskeleton
says	says	say	easy	sas	sassy	sash	sary	sass	sasa	susy	samy	savy	sast
peice	peice
consonants	consonants
airport	airport	airports
openings	openings	pennies	penises	pennines	apennines
consolidate	consolidate
quizzes	quizzes
siezed	siezed
substantial	substantial
principal	principal
goddesses	goddesses
think	think	thunk
refering	refering
kindergarten	kindergarten
grafitti	grafitti
ensure	ensure	censure
stop	stop	sopo	stp	sto	spo	tpo	sapo	sspo
suprisingly	suprisingly
accomplish	accomplish
planed	planed
dipthongs	dipthongs
doesnt	doesnt
blitzkrieg	blitzkrieg
tobacco	tobacco	tobago	toback
boundaries	boundaries	foundries
cemeteries	cemeteries
medieval	medieval
immediately	immediately
ther	ther
occassion	occassion
protagonist	protagonist
polluted	polluted	pouted
cambridge	cambridge	ambridge
criticizing	criticizing
jaques	jaques
possessing	possessing
and	and	abd	nbd	anb	wnbd
immigrant	immigrant
enviroment	enviroment
conservative	conservative
apologetics	apologetics
they	they	thy	teh	tedy	tey	techy	tuhy
occasioned	occasioned
begging	begging	beginner	berliner	bergner	beguines	baggier	bergier	beggin
tendencies	tendencies	tenancies
architects	architects
calculated	calculated
gratuitous	gratuitous
imminent	imminent	eminent
parallel	parallel	paracel
amendment	amendment
primary	primary	pair	praise	dairy	pray	pairs	rainy	fairy	parry	prairie	parity	airy	privy	grainy	hairy	priory	praia	brainy	peary	phair	friary	pricy	kairy	preity	crary	lairy	prady	piry	khairy	pary	pairc	frary
ophthalmology	ophthalmology
boat	boat	bout	boast	bogut	borut	boalt	beaut
vigour	vigour	rigeur	viveur
harrassing	harrassing
sophisticated	sophisticated
before	before	befor
susceptible	susceptible
resemble	resemble	reassemble
goddess	goddess	godless
provided	provided	proved	prodded
sepulchre	sepulchre
certain	certain	keratin
seizing	seizing	sizing	sieving
tendancy	tendancy
emissary	emissary
game	game	gave	gas	age	gay	gap	gate	mae	uae	bae	gao	gaze	gale	gee	gag	gael	rae	gah	gal	gabe	gaz	gage	gaa	gan	gaye	sae	dae	gare	tae	gse	cae	gad	gam	gab	gar	gai	hae	jae	gape	gat	gade	gfe	nae	gac	gau	gea	fae	gbe	lae	gte	gre	iae	gme	pae	gaer	gce	gav	gane	aae	gpe	gye	gie	wgae	gue	gaea	gak
sufficent	sufficent
like	like	luke	linke	litke
pantomime	pantomime
cumulative	cumulative
poison	poison	roisin	oisin	hoisin	voisin
suffrage	suffrage
intelligent	intelligent	intelident
performed	performed	performers	performer	performs
northeastern	northeastern
althought	althought
prefered	prefered
extent	extent	extinct	extant
clinical	clinical	clinically
chemically	chemically
proprietary	proprietary	proprietor	proprietors
aquire	aquire
philippines	philippines	phillipines
muscles	muscles	mussels
imitated	imitated
neighbour	neighbour
attendance	attendance
chase	chase	chair	chasm	chaser	char	chas	chass
field	field	feel	fuel	fill	file	fidel	biel	friel	kiel	fil	fel	fief	niel	fien	ciel	viel	riel	ffel	wiel	feil	piel	fies	fitel	figel	fie	finl
unnecessarily	unnecessarily
aging	aging	gina	vagina	angina	alina	amina	adina	agita	agin	agia	agila	arina	akina
privileges	privileges	priviledge	privelege	privledge	priviledged
embarrass	embarrass
altho	altho
perpendicular	perpendicular
symmetry	symmetry	symmetrical	symmetric	symmetrix
transcendentational	transcendentational
comeback	comeback	commack	colback
intelligence	intelligence
embezzled	embezzled
succession	succession
tommorrow	tommorrow
love	love	loe	looe	voe	lvov	lvo	lavoe
cruises	cruises	crushes
evaluated	evaluated	reevaluated
wild	wild	weird	wield	weill	weil	weld	weald	neild	feild
criticism	criticism
prevent	prevent	prevalent
eclipse	eclipse
adminstration	adminstration
pilgrimages	pilgrimages
occurrence	occurrence	occurance
beautiful	beautiful	beautifully
acording	acording
identical	identical
bible	bible	liable	libel	lille	libre	lisle	litle	wible	lidle	lable
unusable	unusable
ahem	ahem	chev	phev	ahve	hev
peninsular	peninsular
adolescent	adolescent
Muhammadan	Muhammadan
married	married
algorithm	algorithm
field	field	feels	fields	files	fuels	fills	niels	fils	fels	fiefs	fies
suprisingly	suprisingly
beginners	beginners	berliners	beguines
really	really	rally	orally
boundary	boundary	foundry
assistant	assistant
enviroment	enviroment	enviornment
privileged	privileged	privelege
equatorial	equatorial
south	south	fourth	hourth
logical	logical	illogical
leo	leo	aveo	lvo
stop	stop	shop	soup	sop	slop	sup	sump	uop	siop	swop	supp	suo
really	really	realy	reall
game	game	gave	gas	age	gay	gap	gate	mae	uae	bae	gao	gaze	gale	gee	gag	gael	rae	gah	gal	gabe	gaz	gage	gaa	gan	gaye	sae	dae	gare	tae	gse	cae	gad	gam	gab	gar	gai	hae	jae	gape	gat	gade	gfe	nae	gac	gau	gea	fae	gbe	lae	gte	gre	iae	gme	pae	gaer	gce	gav	gane	aae	gpe	gye	gie	wgae	gue	gaea	gak
ammendment	ammendment
synonymous	synonymous
nothern	nothern
describe	describe	decribed
withing	withing
tapanes	tapanes
succession	succession	secession
love	love	loeb	loew	lev	liev	loe	louv
varieties	varieties	vanities	rarities	verities	parities
useage	useage
originally	originally
miranda	miranda	veranda
accommodated	accommodated	accomodate
seceded	seceded
occuring	occuring
competent	competent
deal	deal	del	dale	duel	gael	dahl	adel	dal	dae	cael	dail	wael	dall	yael	kael	daul	rael	lael	doel	daei	jael	daep	danel	darel	daal	deel
beggin	beggin
last	last	past	east	test	fast	cast	task	vast	taste	toast	tasty	tait	tart	mast	nast	taut	taft	tat	tact	tase	ast	tasc	rast	tass	wast	tas	gast	bast	tash	hast	tsat	tant	oast	taht	tats	tost	tst	tasi	sast	tasr	taso	kast
diphtongs	diphtongs
officials	officials	official	officially
dighton	dighton
similarity	similarity
symmetry	symmetry
abandons	abandons
negotiation	negotiation	negotations
specify	specify	specie
primitive	primitive
allopones	allopones
existent	existent
surreptitious	surreptitious
achieves	achieves	acheive	acheived
brilliant	brilliant	brillant
some	some	smoke	shoe	smog	moe	soe	sme	smos	sloe	smee	smote	sioe	ssoe
distinguished	distinguished
swimming	swimming	swiping	shiming	sliming
archaeologists	archaeologists	archeologists
alleged	alleged
pregnancies	pregnancies
soliloquy	soliloquy
going	going	aging	owing	ogling	ging	oginga
anomalous	anomalous
begining	begining
decide	decide	recipe	reside	recede	recite	recife
separates	separates	seperate	seperated
presense	presense
valuable	valuable	voluble
calculate	calculate
genitalia	genitalia
volunteers	volunteers
linguistics	linguistics
during	during	bring	buying	burning	boring	burying	luring	curing	bering	baring	busing	turing	burling	burping	burin
visting	visting
nutrients	nutrients
time	time	timney	tine	tiene
sence	sence
introduce	introduce
approximately	approximately
structure	structure
mystery	mystery	misery	mastery	mister	mistry
licence	licence
propeller	propeller
souvenir	souvenir	convener	govenor	gouverneur	governer	govender
jeopardy	jeopardy
equilibrium	equilibrium
autor	autor
designed	designed
agriculturalist	agriculturalist
nataline	nataline
rewrite	rewrite
succeeded	succeeded
controversy	controversy
theives	theives
assasinated	assasinated
copy	copy	coy	cpo	choy	croy	cpos	poy	cpoe
nuremburg	nuremburg
achieved	achieved	archived	acheived
minister	minister	ministry	ministers
percieved	percieved
perhaps	perhaps	perches	perham	perps	cephas	serpas	pirahas
covered	covered	converted	coveted
achieved	achieved	archived	acheived
required	required	reacquired
shining	shining	shinning
roughly	roughly	roughy	rougle
advice	advice	advised	advices
procedure	procedure	prodger
adopted	adopted
existance	existance
filament	filament
disagreement	disagreement
difficulty	difficulty
contributer	contributer
defiantly	defiantly	definately	definetly	definitly
popularity	popularity
learn	learn	lean	leaner	lear	leans	leann	leant	leang	leane
spreadex	spreadex	spreader
anounced	anounced
strategic	strategic
schedule	schedule
europeans	europeans	utopians
principle	principle
make	make	makes	masse	manse	maks	mase	maske
surrounding	surrounding
characterized	characterized
continuously	continuously
divisions	divisions	divison
happening	happening
intuitively	intuitively
noticing	noticing
recommended	recommended
dissatisfied	dissatisfied
work	work
sepulchre	sepulchre
privileges	privileges	priviledge	priviledged
souvenirs	souvenirs
wether	wether
occasions	occasions
ligature	ligature
exacerbate	exacerbate	exelate
bernoulli	bernoulli
untill	untill
than	than	tan	kahn	hahn	bahn	taha	ahn	jahn	cahn	zahn	tarn	tain	rahn	mahn	tahu	taht	tahi	tah	gahn	dahn	tann	tahr	thn	sahn
pollinator	pollinator
myriad	myriad
acheived	acheived
efforts	efforts	affords	efford	jeffords
incompetance	incompetance
possibly	possibly	passably
dream	dream	dera	dram	derham	derma	derm	eram
incompetant	incompetant
denigrating	denigrating
hygiene	hygiene
internation	internation
personel	personel
millenium	millenium
crucifixion	crucifixion
controls	controls	controll
disobedient	disobedient
infectious	infectious
clear	clear	clare	clair	claes	claar	cler	clader	claver
anonymity	anonymity
compromise	compromise
institution	institution	insitutions
literature	literature
peninsular	peninsular
boat	boat	bout	boast	bogut	borut	boalt	beaut
deal	deal	del	dale	duel	gael	dahl	adel	dal	dae	cael	dail	wael	dall	yael	kael	daul	rael	lael	doel	daei	jael	daep	danel	darel	daal	deel
unsuccessful	unsuccessful	unsuccessfully
connived	connived
programs	programs	pogroms
independent	independent
contaminate	contaminate
recommending	recommending
discovers	discovers
acquaintance	acquaintance
define	define
suppose	suppose
chemical	chemical
collegues	collegues
predecessor	predecessor
environments	environments	enviroment	enviornment
appearances	appearances	appearence
time	time	them	ties	tied	tim	tie	item	tier	diem	tem	siem	tien	teem	timm	kiem	tiea	tsem	liem
opposite	opposite
peculure	peculure
commissioning	commissioning
offically	offically
marketing	marketing
prohibition	prohibition
marraige	marraige
resembling	resembling	reassembling
immense	immense
jospeh	jospeh
misdemeanors	misdemeanors
unpleasant	unpleasant
perhaps	perhaps	perches	perham	perps	cephas	serpas	pirahas
unsurprising	unsurprising
use	use	rise	wise	guise	uist	ise	vise	lise	bise	mise	luise	uis
learn	learn	lean	leaner	lear	leans	leann	leant	leang	leane
arrangement	arrangement
dyer	dyer	veer	yer	myer	ayer	iyer	ver	tyer	vier	byer	nyer	vye	syer
diety	diety
becomming	becomming
proceed	proceed	preceded	proceeded
suceed	suceed
aerials	aerials	aeriel
the	the	tthe
gratefully	gratefully	dreadfully	fretfully	greatful
approximately	approximately
quarantine	quarantine
reponse	reponse
says	says	say	easy	sas	sassy	sash	sary	sass	sasa	susy	samy	savy	sast
autobiography	autobiography
imitator	imitator
doub	doub
villain	villain	violin	millin	killin	villian	villi	villis
opposition	opposition	position
phenomena	phenomena
technicians	technicians
else	else	isle	elle	este	esme	esl	sele	sle	ese	eske	esse	eslt	esler	ehle	eslc
distinguish	distinguish
goverment	goverment
muscles	muscles	mussels
thrid	thrid
fanatics	fanatics	fanatic	fanaticism	fatalism
dependents	dependents	descendents	defendents	decedents
neighbours	neighbours
concerned	concerned	conserved
making	making	kaing
achievments	achievments
whole	whole	holy	wholly	wooly	wholey
harrassed	harrassed
doing	doing	dong	doni	doig	honig	donis	dodig
certain	certain	keratin
assemble	assemble
taking	taking	talking	flaking	slaking
decide	decide	desire	beside	reside	deeside	deride	desde
restraint	restraint
consolidated	consolidated
versa	versa	yerba	yers	persa
simultaneous	simultaneous
character	character
penalty	penalty
plotted	plotted	slotted	allotted	blotted	clotted
exaggerate	exaggerate
verification	verification
census	census
securing	securing	recurring	rescuing	lecturing	recouping	occuring	reoccurring	recusing	rescoring
immigrants	immigrants	inmigrantes
disasterous	disasterous
instate	instate
irritable	irritable
erected	erected	rested	crested	wrested
ukranian	ukranian
criticizing	criticizing
abandoning	abandoning
scroll	scroll	scola	stoll	scold	scowl	scholl	coll	scull	skoll	soll	scolr
perturbation	perturbation
curr	curr	scurr
debateable	debateable
parakeets	parakeets
omitted	omitted	vomited
preceeded	preceeded
unrepentant	unrepentant
temperature	temperature
nuclear	nuclear	nucular
retaliated	retaliated
seat	seat	heat	sheet	wheat	sweat	cheat	shea	shear	sheath	sheaf	shean	shead	skeat	shat
postion	postion
committing	committing	omitting
prophecy	prophecy
surrender	surrender
preceeding	preceeding
used	used	unused	unwed	unser	unseld	unfed
volunteered	volunteered
recipients	recipients
subtract	subtract
infiltrate	infiltrate
occur	occur	occurs
privelege	privelege
occassions	occassions
insitutions	insitutions
unsuccessful	unsuccessful
androgen	androgen	androgens	androgyny
lavatory	lavatory
naturally	naturally
toward	toward
first	first	firms	fires	fits	firth	fists	firsts	forts	flirts	firs	frits	farts	firas	fiats	virts	fitts
palestinian	palestinian
succession	succession	secession	suction	suasion	sunesson
specimen	specimen
independant	independant
venomous	venomous
lieing	lieing
analogous	analogous
withdrawl	withdrawl
accuracy	accuracy	curacy
story	story	sorry
commandos	commandos
the	the	type	tyre	tyne	tye	tthe	tyke	tyce	thye	tyme	wyhe
nineteenth	nineteenth
concentrated	concentrated
intergration	intergration
persuades	persuades
preparation	preparation
execute	execute
corresponding	corresponding
artillery	artillery
sherif	sherif
propagates	propagates
support	support
electic	electic
incurable	incurable	incurably
wnat	wnat
friends	friends	fiends
possesion	possesion
story	story	stoy	stour	stoor	storr	steyr	stor
reference	reference
distin	distin	tintin	nitin	yixin	sittin	fixin	pixton	lixin
misdemeanor	misdemeanor
commiting	commiting
interbreed	interbreed	interbred
couturier	couturier
philosophical	philosophical
leaded	leaded
attitude	attitude
considers	considers
torsional	torsional
strand	strand	strad
inflammation	inflammation
develope	develope
peripatetic	peripatetic
villify	villify
grammatical	grammatical	grammatically
abandoned	abandoned
eraticly	eraticly
suppressed	suppressed	supressed
neccessary	neccessary
attainder	attainder
anoint	anoint
recommending	recommending
acquire	acquire	aquire
controversy	controversy
convention	convention	conversion	convection	convertino
embarassing	embarassing
surreptitiously	surreptitiously
essential	essential
surreptitiously	surreptitiously
happened	happened
emigrated	emigrated	migrated	immigrated
weaponry	weaponry
unsurprised	unsurprised
disaster	disaster
three	three	threes	threet
today	today	tonya	toya	toda
caracas	caracas	carcass	caras	carcase	arcas
find	find	didn	finn	fin	fide	fido	fida	fien	fidm	fidh
taht	taht
1922	1922
clinical	clinical
caracter	caracter
correspondant	correspondant
rhyme	rhyme
origin	origin	organ	orrin	orkin	orin	ergin	orlin	orbin	rogin
phonograph	phonograph
claimed	claimed	blamed
accomodating	accomodating
casino	casino	casio	casson	cason	cision	canion	caison	cashion
converters	converters
exaggerated	exaggerated	exacerbated
other	other	stehr
college	college	colleague	collegues
convenient	convenient
boundary	boundary	foundry
critisize	critisize
enormous	enormous
general	general	generally	generals	generale	generali
atheistic	atheistic
barbeque	barbeque
notably	notably
accomodations	accomodations
ideas	ideas	ides	idles
stubbornness	stubbornness
aggrieved	aggrieved	grieved
structured	structured
refrigerator	refrigerator
embarassment	embarassment
traditional	traditional	traditionally
nwo	nwo
exaggerates	exaggerates
contained	contained	contains	container	containers
imminent	imminent	eminent
disappearing	disappearing
commisioner	commisioner
strategies	strategies
doing	doing	doig	doin	deign
ceasar	ceasar
saftey	saftey
guaranteed	guaranteed
disobedience	disobedience
habitats	habitats
else	else	eyes	les	els	ales	lees	eels	elves	meles	elms	seles	exes	ewes	elses	elvs	elks	eley	eves	iles	elis	eales	ekes	elles	elwes	ees	ells	elen	eres	teles	eyles	elec	elies	oles	elmes	elkes	efes	eeles
dominant	dominant
quite	quite	tie	quiet	quit	tune	tube	quiz	quid	louie	que	tui	quip	cutie	qui	qurie	qube	tue	quin	tuke	quik	buie	quim	etude	quine	tule	thie	attie	quis	itune	tude	quil	quien	atie	ture
died	died	idea	die	diet	dies	diva	dea	iea	dina	dia	diem	dita	dida	diya	diaa	dima	disa	dieu	dhea	diez	diep	diena	drea	dien	tiea	niea	dmea	deia	aiea
designed	designed	destined
decipher	decipher
succesful	succesful	succesfully	successfuly
field	field	feel	fuel	fill	file	fidel	biel	friel	kiel	fil	fel	fief	niel	fien	ciel	viel	riel	ffel	wiel	feil	piel	fies	fitel	figel	fie	finl
repair	repair	prepaid
practitioner	practitioner
excell	excell
maneuverable	maneuverable
alot	alot
whole	whole	hole	wole	howle	hoole
temperate	temperate
condemned	condemned
neccessarily	neccessarily
supposedly	supposedly
managment	managment
quite	quite	cutie	qurie
maneuvers	maneuvers
parallel	parallel
little	little	litter	littell	vittel	lintel	litte
during	during	purring	durning	furring	derring
constituents	constituents
nazareth	nazareth	azeroth
guard	guard	gourd	gard	gaur	gauri	gaura
liked	liked	lied
valuable	valuable
next	next	ext	ent	nxt
program	program	pogrom
universities	universities
recipient	recipient
enormously	enormously
ophthalmologist	ophthalmologist
surprise	surprise
years	years	eras	veras	yers	yeas	heras	yuras	jeras
suprised	suprised
european	european
rigeur	rigeur
aggregate	aggregate
unneccessary	unneccessary
entertaining	entertaining	intertwining
imminent	imminent	eminent	manet	tranent	imagen
surrounds	surrounds
journey	journey	journeys	journals	juries	fournier	journos	johnnies	mournes
jsut	jsut
particular	particular
origin	origin	organ	orrin	orkin	orin	ergin	orlin	orbin	rogin
field	field	feel	fuel	fill	file	fidel	biel	friel	kiel	fil	fel	fief	niel	fien	ciel	viel	riel	ffel	wiel	feil	piel	fies	fitel	figel	fie	finl
proceeds	proceeds	precedes
competant	competant
this	this	ties	tips	ihs	tins	tits	tics	tis	iihs	tish	ths	tims	tias
acres	acres	aires	padres	andres	ares	dares	cadres	ayres	adores	adrs	adre	ades	adrem	apres	adrees	adress
dominant	dominant
relationship	relationship
emmisarries	emmisarries
inaccessible	inaccessible
between	between
soliders	soliders
tomatoes	tomatoes	tomato
great	great	herat	gera	erat	gert	gerut	geral	geraty
prominence	prominence
available	available
asymmetric	asymmetric
definite	definite
script	script
covered	covered	converted	coveted
sense	sense	sese	snee
cooperation	cooperation
necessarily	necessarily
beleives	beleives
neccessarily	neccessarily
relevent	relevent	irrelevent
the	the	thee	thg	toge	thre	thie	thye	thse	thae
capability	capability
annual	annual	manual	anal	andal	anfal	antal	anuak
councillor	councillor	counsellor
residents	residents
charities	charities	christies	charisteas
game	game	gave	gas	age	gay	gap	gate	mae	uae	bae	gao	gaze	gale	gee	gag	gael	rae	gah	gal	gabe	gaz	gage	gaa	gan	gaye	sae	dae	gare	tae	gse	cae	gad	gam	gab	gar	gai	hae	jae	gape	gat	gade	gfe	nae	gac	gau	gea	fae	gbe	lae	gte	gre	iae	gme	pae	gaer	gce	gav	gane	aae	gpe	gye	gie	wgae	gue	gaea	gak
again	again	asian	avian	gian	arian	agin	agia	agan	agran	bagian
connotation	connotation	annotation
harrasment	harrasment
constituent	constituent
memeber	memeber
dependancy	dependancy
paid	paid	aide	pride	paige	paine	paice	pande	waide
strategy	strategy	stategy
peopel	peopel
place	place	pace	palace	pale	palme	paice
knows	knows
protuberances	protuberances
disappears	disappears
infinite	infinite	infinity	infiniti	infinito	infinis
currently	currently	currency
impudence	impudence	impedance
caracas	caracas	carcass	caras	carcase	arcas
enamored	enamored
solitary	solitary
ophthalmic	ophthalmic
severely	severely	beverley	peverley	severly
ratify	ratify	adify
evidently	evidently
mathematicians	mathematicians
rabbinical	rabbinical
neice	neice
indisputable	indisputable
committing	committing	omitting
succeeding	succeeding
couturier	couturier
nessasarily	nessasarily
position	position	poston	positron	postion
calculated	calculated
restoration	restoration
like	like	link	lies	lie	lied	lieu	lien	lick	leek	liev	lek	lieb	liew	lier	riek	piek	lief	lik	niek	liem
relations	relations	vacations	valuations
turn	turn	turns	trunk	turk	turok	turek
surprisingly	surprisingly
conform	conform
essential	essential
ceremonious	ceremonious
ikea	ikea	mea	kea	skea	mdea
census	census	censure	censor
strived	strived
dimensions	dimensions
proclaimed	proclaimed
constituencies	constituencies
immediately	immediately
defendant	defendant	descendant	dependant
volcano	volcano	volcanoes	volcanos
sophicated	sophicated
efficient	efficient
archaeology	archaeology
relevance	relevance
suprising	suprising
anything	anything
responsibilty	responsibilty
immigration	immigration	migration	emigration
missle	missle
vomiting	vomiting	commiting
succeeded	succeeded
clear	clear	clerk	clara	cera	clerc	celera	calera	clea	llera	cler	cleri	lera	cleta
influential	influential
secretary	secretary
guatemalan	guatemalan
accessible	accessible
equiped	equiped
significantly	significantly
environmentally	environmentally
pejorative	pejorative
suprised	suprised
pineapple	pineapple
cervical	cervical
suppresses	suppresses	supressed
speach	speach
survivors	survivors	survives
idea	idea	idle	ida	dae	ide	iae	idan	irae
several	several
realy	realy
patented	patented
write	write	rite
embarrased	embarrased
prefering	prefering
consider	consider
aging	aging	gina	vagina	angina	alina	amina	adina	agita	agin	agia	agila	arina	akina
really	really	rally	orally
metamorphosis	metamorphosis
pumpkin	pumpkin	punkin
licence	licence
ceremony	ceremony	cerimon
Carthagian	Carthagian
buffalos	buffalos
commissioning	commissioning
poundland	poundland
ceremonies	ceremonies
independently	independently
nataline	nataline
restaurants	restaurants	restraints
condition	condition
auxiliary	auxiliary
architect	architect
apartments	apartments	appartment
strongest	strongest	sternest
demographic	demographic	geographical	demographics	demographically
cartographer	cartographer
wich	wich
chase	chase	chair	chasm	chaser	char	chas	chass
advertisments	advertisments
peninsula	peninsula
poses	poses	possess	posses	posers
excels	excels	excell	excellus
prologomena	prologomena
finally	finally
eminently	eminently	imminently
neccesary	neccesary
trafic	trafic
corporate	corporate	corperate
year	year	years	east	easy	eyes	ease	ear	ears	erase	yar	yeast	eras	nasr	emaar	essar	asr	yasir	yas	exar	yair	eraser	esas	yasar	emas	euas	qasr	dyas	eyal	eeas	yash	eas	easa	yaser	byars	eyfs	byas	yeas	eussr	ecast	vyas	kyar	epas	easl	eyak	easi	eyad	eatr	eyam	egarr	yaar	ecas	evas	yass	tasr	eya	ayar
acheive	acheive
algebraic	algebraic
clearance	clearance
every	every	ever	evey
taxonomy	taxonomy
commision	commision
editing	editing	exiting	emitting	emoting	smiting
presidental	presidental
kwon	kwon	kano	keno	kino	kono	wno	kno
learns	learns	leans	lemans
executes	executes
field	field	feels	fields	files	fuels	fills	niels	fils	fels	fiefs	fies
refered	refered
sucess	sucess
theater	theater	heather	teather
commited	commited
directly	directly
thing	thing
makes	makes	maes
paletta	paletta	valetta
maneuver	maneuver
decomposing	decomposing	decomposes
during	during	bring	buying	burning	boring	burying	luring	curing	bering	baring	busing	turing	burling	burping	burin
environmentalist	environmentalist
translates	translates	translators
adressing	adressing
problem	problem
external	external	exertional
decomposing	decomposing	decomposition	compositing
particularly	particularly	particularity
symmetrical	symmetrical
financial	financial	financially	financials
inevitable	inevitable
octohedral	octohedral
propellers	propellers
will	will	ill	wll	pwll
harassment	harassment	harrasment
rockefeller	rockefeller
dieing	dieing
recall	recall	reall
behaviour	behaviour
spectacular	spectacular
definately	definately
guatemala	guatemala
renown	renown
recieve	recieve
accommodates	accommodates	accomodate
beginning	beginning	begining
foriegn	foriegn
know	know	kong	kony	kona	kone	kono	kon	koni	kow
undecideable	undecideable
commander	commander	colander
drink	drink	drik
southern	southern
transcending	transcending
than	than	then	think	thin	tin	tick	titan	ticks	tian	tiki	tien	tikka	tik	nihon	thion	tink	thun	timken	thien	tirin	tike	tchen	tinh	timan	thon	tiven	tilke	cihan	timon	timko	tikkun	tihany	tiran	dihk	yihan	tion	tigon	tihar	thn	thika
acquaintance	acquaintance
irresistibly	irresistibly
jamal	jamal	mama	mahal	kamal	mammal	gamal	amal	mamas	yamal	maal	maman	manal	mamah	namal	mamat	magal	matal	samal
mischievous	mischievous
sincerely	sincerely
mear	mear
privileges	privileges	privelege
enviornment	enviornment
maintenance	maintenance	maintainable
anomalies	anomalies
superintendant	superintendant
embarrasing	embarrasing
refers	refers
psychic	psychic	cystic	mystic	pesci	physic	palcic
vomited	vomited	commited	comite	comitted
strengthening	strengthening
continuous	continuous
very	very	veer	ver	vey
categories	categories
effort	effort	afford
vicinity	vicinity
document	document
wasnt	wasnt
absence	absence	adsense
absorption	absorption
indefinately	indefinately
field	field	feels	fields	files	fuels	fills	niels	fils	fels	fiefs	fies
occurance	occurance	occurences
accomodating	accomodating
tyranny	tyranny	tyrant	tarrant
believes	believes	belies	belive	relives	belived	beleives
embarassed	embarassed
suprise	suprise
resemblance	resemblance
councillor	councillor	counsellor
emphysema	emphysema
charismatic	charismatic
beneficial	beneficial
poetry	poetry	petry
field	field	feel	fuel	fill	file	fidel	biel	friel	kiel	fil	fel	fief	niel	fien	ciel	viel	riel	ffel	wiel	feil	piel	fies	fitel	figel	fie	finl
considered	considered
souvenir	souvenir
emirate	emirate	emanate
refusal	refusal
decided	decided	receded	recited	resided
repetition	repetition
corresponding	corresponding
login	login	goggin	goin	godin	gorin	golin	gogii	gobin	rogin
commandoes	commandoes
engineer	engineer	engender
transcendent	transcendent
business	business	buisness	busyness	busnes	burness
celcius	celcius
processing	processing
controling	controling
exceeded	exceeded
engineers	engineers
absorption	absorption
doens	doens
volcanos	volcanos
supressed	supressed
achieving	achieving
octohedron	octohedron
miniature	miniature
available	available
puting	puting
levitated	levitated
knowlege	knowlege
years	years	ears	byars
thsi	thsi
propagate	propagate
defined	defined
cassette	cassette
Missisipi	Missisipi
successive	successive
villain	villain	violin	millin	killin	villian	villi	villis
nuisance	nuisance
millennium	millennium
drumming	drumming
possible	possible	passable
emissaries	emissaries
israelis	israelis	israelites
wich	wich
desparate	desparate
febuary	febuary
dispicable	dispicable
significantly	significantly	signficantly
end	end	need	ended	eyed	ned	enel	eked	enid	enad	ene	enrd	enea	ener
beleived	beleived
immediately	immediately
guerrilla	guerrilla
adhering	adhering
sophomore	sophomore
scholastic	scholastic
notable	notable
metallurgy	metallurgy
sovereignty	sovereignty
which	which	whic
ther	ther
accross	accross
survey	survey	surely	surrey	burley	hurley	surly	turley	curley	sulley	gurley	sutley	purley	sorley	durley	sudley	murley
exaggerating	exaggerating	exacerbating
secretary	secretary	secretory
descendents	descendents
congressional	congressional
deities	deities	ditties	pieties
acquiring	acquiring	squiring
alot	alot
beneficiary	beneficiary
opinion	opinion
imprisonment	imprisonment
tonight	tonight
seat	seat	heat	sheet	wheat	sweat	cheat	shea	shear	sheath	sheaf	shean	shead	skeat	shat
theater	theater	heather	teather
hfea	hfea	hea	hve	vea	svea
caterpillars	caterpillars
mischievous	mischievous
unfortunately	unfortunately
dukeship	dukeship
pronunciation	pronunciation
hace	hace
controversy	controversy
occasionally	occasionally	occasional
extraterrestrial	extraterrestrial
process	process
visible	visible	viable	disable
guarentee	guarentee
mear	mear
necesary	necesary
priviledge	priviledge
competion	competion
survey	survey	surely	surrey	burley	hurley	surly	turley	curley	sulley	gurley	sutley	purley	sorley	durley	sudley	murley
imbalance	imbalance	unbalance
artifically	artifically
forehead	forehead
commissioned	commissioned	commisioner
wether	wether
earnt	earnt
agreeable	agreeable	advisable	addressable	arrestable
mississippi	mississippi
receive	receive	relieve	relive	beleive
fourth	fourth	fought	fouth
occassionally	occassionally
guarantees	guarantees	guarentee
nucular	nucular
impolite	impolite
consumate	consumate
allusion	allusion
succeeds	succeeds	suceed
execution	execution
recieving	recieving
strengthen	strengthen
describes	describes	decries	decribed
vegetable	vegetable	veritable
persistant	persistant
unsurprising	unsurprising
aging	aging	gina	vagina	angina	alina	amina	adina	agita	agin	agia	agila	arina	akina
perogative	perogative
intrest	intrest
deciding	deciding	receding	residing	reciting
sieze	sieze
dramatic	dramatic	drastic
supress	supress
themselfs	themselfs
asteroid	asteroid
caring	caring	carling	carving	carding	carting	carping	wareing
hydrophilic	hydrophilic
sounds	sounds	soudas
environmentally	environmentally
calculate	calculate
environmentalist	environmentalist
useful	useful	usefully
describing	describing
only	only	onyx	onal	ony
away	away	anya	awa	aya	arya	awwa	awea	awja	awaa	awyr	aiya
place	place	pace	palace	pale	palme	paice
brazillian	brazillian
receding	receding	reseeding	preceeding
apologies	apologies
defendants	defendants	descendants	dependants
mear	mear
mucous	mucous
adminstrative	adminstrative
spontaneous	spontaneous
dispite	dispite
buisness	buisness
broady	broady
clear	clear	clerk	clara	cera	clerc	celera	calera	clea	llera	cler	cleri	lera	cleta
having	having	hlaing	haing
cruising	cruising	criticising	critiquing	critisize
happen	happen
adressing	adressing
millipede	millipede
time	time	them	ties	tied	tim	tie	item	tier	diem	tem	siem	tien	teem	timm	kiem	tiea	tsem	liem
guerrilla	guerrilla
rhythm	rhythm	rahim	mythic	lytham	ruthin	ruthie	anthim	rathi
guerrillas	guerrillas
appealing	appealing	appalling
quantity	quantity
incredible	incredible
thing	thing	thin	thigh	thion	thien	teign
dream	dream	dreams
entrepreneur	entrepreneur
happen	happen	haven	haren	hagen	halen	haden	hape	hasen	hazen	hanen	hafen	bapen
specialized	specialized
disobedient	disobedient
overwhelming	overwhelming
consciousness	consciousness
story	story
aslo	aslo
emission	emission	envision	emulsion	edmiston	commision	emilion	emmissions	excision	elision
going	going	gong	honig	goni
unsurprised	unsurprised
proselytizing	proselytizing
wielded	wielded	welded
technician	technician
resistant	resistant
consortium	consortium
carribean	carribean
desparate	desparate
proper	proper	prosper	propped	cropper	popper	dropper	gropper	tropper
dispense	dispense
whole	whole	holy	wholly	wooly	wholey
transcendent	transcendent
nuisance	nuisance	nuance
unwieldy	unwieldy
pseudonym	pseudonym
extent	extent	extinct	extant
ghandi	ghandi	thandi	khandi
enlargements	enlargements
parliamentarian	parliamentarian
adress	adress
beaurocracy	beaurocracy
connecticut	connecticut
recipients	recipients
friend	friend	freund	freinds	frind
disappear	disappear
lsat	lsat
invitation	invitation	imitation	initiation
acquaintance	acquaintance
perhaps	perhaps
judical	judical
thinking	thinking	thinning
secede	secede	seceded	suceed
phillippines	phillippines
greatful	greatful
psychic	psychic
profession	profession	profusion
the	the	tighe	tthe	nghe
have	have	hae	hav	haeg	hev
indispensible	indispensible
constitution	constitution	constitucion
commissioning	commissioning
european	european	turpan	burkean
sucessfully	sucessfully
really	really	rally
satelite	satelite
exaggerating	exaggerating
comitted	comitted
zionist	zionist
copy	copy	coy	cpo	choy	croy	cpos	poy	cpoe
fled	fled	feed	fleet	freed	flee	bleed	leed	flied	flexed	flees
centuries	centuries
religous	religous
substance	substance
incorruptible	incorruptible
years	years	ears	byars
independance	independance
archetypes	archetypes
architecture	architecture
guaranteed	guaranteed	guarentee
purposely	purposely
entrepreneurs	entrepreneurs
coordination	coordination
ophthalmologist	ophthalmologist
repentance	repentance
writing	writing	wiring	wilting	wieting
satelite	satelite
inevitable	inevitable	investible
because	because
diferent	diferent
transfering	transfering
maneuverable	maneuverable
conveyer	conveyer
appartment	appartment
occassionally	occassionally	occassional
attempting	attempting	attesting
criticizes	criticizes	critisize
level	level	levee	lele	leve
cemetary	cemetary
loosing	loosing
country	country
documents	documents
make	make	makes	maker	marked	naked	masked	baked	faked	raked	maxed	mated	caked	jaked	majed	miked	makem	makeda	mayed
fourth	fourth	forty	fouty
strategies	strategies
deficit	deficit	definite	definity
perturbations	perturbations
diffrent	diffrent
not	not	onto	knot	ono	snot	ont	oot	omot	okot
warrent	warrent
pseudonymous	pseudonymous
restraint	restraint
succesful	succesful
imminent	imminent	eminent
bankrupcy	bankrupcy
primatively	primatively
since	since	sense	sins	rinse	sine	sinise	singe	sines
receiver	receiver	reliever	recieved	recieve	recieves
regularly	regularly	regularity
take	take	tae	trae	tkap	thae
proclaiming	proclaiming
aberration	aberration	aeration
converter	converter
anywhere	anywhere
aficionado	aficionado	afficionados
invite	invite	indie	incite	inditex	insite
negotiate	negotiate
almost	almost
discovery	discovery
dimension	dimension
troups	troups
article	article	artical
wont	wont
consummated	consummated	consumate
franciscan	franciscan
resemblence	resemblence
monetary	monetary
rigeur	rigeur
empirical	empirical
shadow	shadow	haddow
beginnings	beginnings	begining
language	language
municipality	municipality
magnolia	magnolia
maneuverability	maneuverability	manoeuvrability
legitimate	legitimate
sucessful	sucessful	successfuly	sucessfully
excellent	excellent	extent	element	exelon	relent	celent	exigent	telent	eyelet
Mohammedans	Mohammedans
messenger	messenger	messinger	messager
guerrillas	guerrillas
medieval	medieval
mysterious	mysterious
executing	executing
probaly	probaly
believing	believing
assassin	assassin
hypocrit	hypocrit
derived	derived
tentacles	tentacles
mysterious	mysterious
culminating	culminating
criticisms	criticisms
time	time	thome	tome	tiote	biome	toome
sepulchre	sepulchre
feel	feel	eel	enel	evel	efe	fel	ebel	edel	exel	ffel	eifel	etel	emel	efes
independently	independently
allusion	allusion
recieved	recieved
explain	explain
elementary	elementary	alimentary
oxymoron	oxymoron
murder	murder	mulder	ruder	mujer	mader	luder	moder	buder	auder
imitating	imitating
commissions	commissions	commision
marriage	marriage	barrage	marraige
guttural	guttural
reaction	reaction	reception	relation	rejection	retention	repetition	depletion	deletion	repton	resection	repetto
definitly	definitly
spanish	spanish
prestigious	prestigious
believes	believes	belies	belive	relives	belived	beleives
pollutes	pollutes	polites
salary	salary	valery
phillipines	phillipines	phillipina
attempts	attempts	attests
exacerbates	exacerbates	exaggerates
contemporaneous	contemporaneous
waht	waht
only	only	lonely	lowly	loney	lolly	lonny
relatively	relatively
consent	consent
reversal	reversal	rehearsal
sould	sould
affluence	affluence
harass	harass	harasses
despair	despair
fungus	fungus	fugues
practical	practical
accomodation	accomodation
hypocricy	hypocricy
desireable	desireable
territories	territories
procedure	procedure
defiance	defiance	refinance
that	that
loneliness	loneliness
recognize	recognize
concensus	concensus
dissemination	dissemination
acquiring	acquiring
erected	erected	rested	crested	wrested
maintenance	maintenance
committed	committed	omitted
knowledgeable	knowledgeable
british	british	skittish	brattish
occassional	occassional
unconsciousness	unconsciousness
sould	sould
irresistibly	irresistibly	irresistable
unsuccessfully	unsuccessfully
touch	touch	torch
consciously	consciously
surrender	surrender
quickly	quickly
promotions	promotions	proportions
premiered	premiered
competive	competive
truely	truely
mischievous	mischievous
proceed	proceed	preceded	precede	preneed
stu	stu	jsut	jst	jsu
spermatozoan	spermatozoan
dependance	dependance
making	making	asking	amping
subsidiary	subsidiary
monetary	monetary
infiltrated	infiltrated
contemporary	contemporary
agressive	agressive
proceedings	proceedings
alchohol	alchohol
pomegranate	pomegranate
immediately	immediately	immediatly
occassions	occassions
strengthened	strengthened
diverse	diverse	diverted	diverged
officals	officals	offical	offically
sandwich	sandwich
permissible	permissible
hypocracy	hypocracy
nickle	nickle
retaliation	retaliation
script	script
collateral	collateral
discovering	discovering
illusion	illusion
recommending	recommending
scholastic	scholastic
scrap	scrap	syrup	strap	syrah
subtracting	subtracting
application	application
influenced	influenced
reponsible	reponsible
Appenines	Appenines
suprise	suprise
occurences	occurences
governer	governer
disintegration	disintegration
archaeologist	archaeologist	archeologist
invented	invented	inventor	inverter
agreed	agreed	agree	aged	aired	agre	alred
rarified	rarified
pressure	pressure	pleasure	leisure
todays	todays
unconventional	unconventional	uncongenial
franciscans	franciscans
expels	expels
committe	committe
disobedience	disobedience
