conflation	conflation	conurbation	ionization	cogitation
wicken	wicken
resemblence	resemblence
critique	critique
contestant	contestant
hefin	hefin
sooner	sooner
sacrilegious	sacrilegious
interest	interest	inserted	inverted	interred	interned	intertek	interead	interwest
opposed	opposed	opposite	oppose	opposing	opposes
madness	madness
miniscule	miniscule
procedures	procedures
amplify	amplify	rampling	samplify
ramification	ramification
divulge	divulge
bankrupt	bankrupt	bankroll	bancroft	barrot	bankrate	banknote	barot	backrow	backlot	bankfoot	bankco	banro
enlistment	enlistment
masterly	masterly	mannerly	majorly
frustration	frustration
computer	computer
confident	confident
polygamy	polygamy
drunkeness	drunkeness
commitment	commitment	committment
graceful	graceful	gracefully
inefficient	inefficient
about	about	abou	aboul	aboud
parapets	parapets
developed	developed
download	download
sylph	sylph
mischievous	mischievous
hypotathes	hypotathes
column	column	columns	columned
herbert	herbert	sherbet
obfuscate	obfuscate
asterisk	asterisk
reckons	reckons	reckon	recon	cecconi	resona	recchia
languages	languages
voluptuous	voluptuous
bud	bud	buds	burr	bdr	budd	badr	burd	bude	bur	budi	buda	udr	budo	buder	buhr
hard	hard	ward	wharf	chard	shard
portray	portray
humanity	humanity
descrptn	descrptn
room	room	soon	moon	roof	ron	root	noon	boon	hoon	yoon	coon	toon	loon	troon	rood	roos	doon	roo	goon	croon	rook	roan	roxon	kroon	poon	broon	rion	ronn	rono	koon	woon	rohn	joon	roone	rolon	rooi
waite	waite
salut	salut
hypotathese	hypotathese
subpoena	subpoena
volpe	volpe	vole	volte
exceed	exceed
possible	possible	passable
dag	dag
ecstacy	ecstacy
general	general	energy	generally	beverly	generals	generic	gently	generale	geely	gingerly	gentry	tenderly	generali	genel	gnarly	everly	henery	generis	severly	genera	zenergy	kennerly	geners	meneely
recommend	recommend
radios	radios	radius	radioss
influential	influential
adultry	adultry
cocamena	cocamena
tomorrow	tomorrow
grammer	grammer
subscribed	subscribed
interpretive	interpretive	interpretative
euro	euro	bear	beauty	bears	beard	beau	mauro	delauro	teatro	lauro	beaux	beano	baur	beaufoy	neuro	beauly	beaune	barro	seguro	beare	beato	beaute	buturo	sauro	beaus	tauro	beaut	beaudry	beart	buro	beause	bearup	banro
noticeably	noticeably	noticable
region	region	precious	precise	preston	precision	reckon	brecon	erection	prebon	previn	grecian	prion	recon	preqin	prenton	recio	precis	premios	premio	procon	prision	breckon	arcion	precor
neccessary	neccessary
critique	critique
inconvenient	inconvenient
fantasia	fantasia
isotope	isotope	strop
simply	simply	simple
objection	objection
peremptory	peremptory
super	super	sugar	luger	suter	auger	surer	ruger	seger	suge	sager	huger	sumer	suber	suker
inventions	inventions
etiology	etiology
definite	definite
segments	segments
enhance	enhance
epitome	epitome
version	version	verizon	venison
majorly	majorly
desparate	desparate
encyclopedia	encyclopedia
snuck	snuck
definately	definately
sicolagest	sicolagest
bureacracy	bureacracy
autoamlly	autoamlly
rsx	rsx
polution	polution
unatourral	unatourral
commited	commited
trade	trade	strategy	traded	traders	tragedy	trades	trader	tracey	stradey	tracery	trademe
perogative	perogative
wierd	wierd
nuncio	nuncio
auction	auction	function	fiction	faction	suction
kilometer	kilometer
coal	coal	coals	coale	coan	colan
user	user	laser	loser	luster	luger	buser	luder	luker	lusher	lumer
respect	respect
privilege	privilege	priviledge	privelege
crucifixion	crucifixion
flu	flu	flux	flak	fluke	flue	flub	flus	flunk	kluk	fluky	luk	fuk	pluk
leisure	leisure	esure
draft	draft	dealt	deaf	deft	daft	delft
writting	writting
howver	howver
singal	singal
sence	sence
higher	higher	tiger	niger	iger	hiker	hager	eiger	hier	hiper	huger	hider	giger	hirer	heger
speak	speak	soak	spock	spook	smoak	spork
intelligent	intelligent	intelident
expresso	expresso
dessicated	dessicated
nations	nations	actions	options	sections	emotions	editions	mentions	motions	notions	rations	lotions	potions	exertions	exton	extols	vexations
syncorization	syncorization
flattering	flattering
ident	ident
behaviour	behaviour
olf	olf
colleague	colleague
presume	presume	presse	presque	persue
copping	copping
simplicity	simplicity	complicity
occurence	occurence
priviledge	priviledge
safely	safely	softly	saftey
tattoo	tattoo	tattoos	tatton	mattos
thw	thw
octogenarian	octogenarian
contact	contact	contest	contrast
independant	independant
internation	internation
inconvenience	inconvenience	incontinence
nevada	nevada	evade	nevado
brose	brose
direct	direct	dissect	bisect
judgement	judgement
inadvertent	inadvertent
kilometer	kilometer
recognise	recognise
independent	independent
caller	caller	hauler	causer	cauley
test	test	tests	tessa	tess
envireminakl	envireminakl
amorous	amorous
beleive	beleive
dur	dur
rectangles	rectangles
problematic	problematic
elliott	elliott	illicit	elliot	elicit
effect	effect	efficacy	effient	offical
media	media	midi	lidia	madia	vidia	nidia
what	what	wheat	wanat	hayat	bharat	bhagat	haart	chabat	khayat	waaaay	waart	waaay	chaat	whyatt	waaah
asentote	asentote
teo	teo
bouyant	bouyant
intellegent	intellegent
expleyly	expleyly
attentively	attentively
asymmetric	asymmetric
mature	mature	armature
interface	interface
butter	butter	buster	buiter	bunter	buder
losing	losing	tossing	lessing	loosing	glossing	flossing	bossing
irresistable	irresistable
liason	liason
intellegent	intellegent
crash	crash	crazy	crass	cray	cras	crary	creasy	crays
incomplete	incomplete
existence	existence	insistence	persistence	resistence
commercial	commercial	commercials
taff	taff
smil	smil
fine	fine	hiring	hiding	define	hiking	divine	refine	hine	heine	hifn	hirise	hiving	haine	sihine	hikind	hefin	hifi	mifune	hijane	visine
minus	minus
gotten	gotten	cotton	gorton	botton	totton	wotton	otton	potton	gotto	gatton
prefaces	prefaces	prefixes
being	being	begin	begins	begging	bering	bening	bejing	beeing
tyranny	tyranny	tyrant	tarrant
turnout	turnout	throat	thrust	trout	tryout
defense	defense
450	450
fantasy	fantasy
face	face	fame	fate	fake	fare	fade	axe	fax	faye	faxed	faxes	faze	fave	fixe	fae	fane	saxe	foxe	fale
pronunciation	pronunciation
defence	defence
dissipate	dissipate
running	running
goverment	goverment
hysterical	hysterical
oscilloscope	oscilloscope
seperate	seperate
neighbour	neighbour
buder	buder
organic	organic	organize	organis
housing	housing
house	house	hours	course	horse	bourse	hoarse	nourse
pronunciation	pronunciation
properly	properly
expedient	expedient
indispensible	indispensible
replacements	replacements	repayments
orientate	orientate
embarass	embarass
partrucal	partrucal
loyer	loyer
unnatural	unnatural
practice	practice
warlord	warlord
absorption	absorption
craves	craves	cravens	kravets	cravats
intellegent	intellegent	intelident
tem	tem
cycle	cycle	circle	icicle	cicale	cille
game	game	gagne	gamine	gawne	gane
have	have	haven	havre	hayne	haine	havn	hanne	havner
neighbor	neighbor
john	john	johan
phenomenal	phenomenal
turned	turned	tired	toured	lured	tuned	cured	turd	turfed	turek	ture
accommodate	accommodate
thredically	thredically
necesary	necesary
waiting	waiting	wanting	wasting	wading	wafting	wadding
permissible	permissible
confident	confident
liaison	liaison	liasson	liason
ths	ths
court	court	course	courts	cours
appreciated	appreciated
continue	continue	connie	contini
government	government
efforts	efforts
illegitament	illegitament
insistent	insistent
maintenance	maintenance
companys	companys
sponsored	sponsored
leave	leave	lease
unconditional	unconditional
rubble	rubble	rubber	rubbed	gruebel	grubber	rubel	trumble	drubbed	tribble	grubel	grubbed	trudel
dramatic	dramatic	dramatically	dramatics
directly	directly
spel	spel
eighth	eighth	height	heights
complicated	complicated
intelligent	intelligent
circle	circle	circus	cirque
forsee	forsee
pragmatism	pragmatism	pragmatics
croke	croke
intelligent	intelligent	intellect	intellegent
help	help	hell	heels	hello	heel	hells	heeled	heeley	hella	heslop	helly	helle	heeler	heep	hewell	hellip	peelle	heelys
monday	monday	monkey
colloquialism	colloquialism
test	test	attest
committe	committe	comite	comittee	comitted
acquaintance	acquaintance
irregardless	irregardless
cosmoplyton	cosmoplyton
intelident	intelident
section	section	scion	seccion
organise	organise
auctioneer	auctioneer	auctioneers
especially	especially	respectably
yield	yield	neild	feild
dramatic	dramatic	dynamic	dogmatic	dynastic	somatic	matic	demotic	nymagic
agent	agent	element	elegant	lament	latent	exigent	reagent	plangent	telegent	largent	clagett	blatent	alegent	legent	sagent
latest	latest	latex	latent
enviroment	enviroment
tialata	tialata	titillate	tinplate
kippur	kippur
committment	committment	comitted
announcment	announcment
mouse	mouse	mousa	mousy	mous	mouser
disssicion	disssicion
bureacracy	bureacracy
begining	begining
buch	buch
benifits	benifits
recieve	recieve
occasionally	occasionally	occasional
fluke	fluke	flukes
themselves	themselves
however	however	howver
theridically	theridically
ferrara	ferrara	errata
insulation	insulation
picaresque	picaresque
sieze	sieze
subisitions	subisitions
frank	frank	rank	drank	prank	crank	wrack	wank
you	you	your	yore	yue	yoke	youre	yobe	yous	youn	youk	youve	yohe	youse	youm	youd
prefix	prefix
exhilaration	exhilaration
susan	susan
neice	neice
club	club	lob	clot	clog	blob	clos	cob	clo	slob	glob	clow	clb	clov	clod	cloe	colb
police	police
customisation	customisation
intellegent	intellegent
pressed	pressed	presumed
batallion	batallion
imminent	imminent
destroy	destroy	distro	distros
excercise	excercise
mic	mic
governement	governement
test	test	gets	tests	sets	tens	jets	mets	lets	nets	pets	bets	tents	texts	vets	tees	ets	teas	tess	tots	tits	tet	tkts	tett	tes	wets	tts	tete	teds	teta	tetsu	teats	tats	teus
daly	daly
indepnends	indepnends
evaluation	evaluation	evacuation
creditability	creditability
accusingly	accusingly
efficacy	efficacy	affinity	felicity
implements	implements
harrass	harrass
millenium	millenium
deities	deities	ditties	pieties
aggresive	aggresive
require	require	equine	esquire	squire	enquire	aquire
one	one	done	gone	fine	none	zone	tone	bone	lone	fond	foe	cone	fore	foie	hone	font	foye	fong	kone	sone	wone	fon	mone	fonte	fonz	fyne	fane	ione	foner	fose	jone	rone	foxe	fons
bought	bought	boycott	boot	forgot	bogota	bongo	bogut	bigot	boyko	bongos	borgo	boyett	bogor	boyet	bogost	bogof	borght	begot
immediately	immediately	immediatly
encapsulation	encapsulation
repetition	repetition
judgment	judgment
preceeding	preceeding
resign	resign	reign	reding
nickelodeon	nickelodeon
aratictature	aratictature
site	site	sitter	sirte	witte	mitte	sitt	sittwe	sette	siete	bitte	litte
door	door	dog	doug	doom	dong	dogg	doo	goog	doon	doig	moog	dogo	droog	boog	doot	dood
ingenious	ingenious	insidious	invidious	incurious
believe	believe	allies	alive	achieve	allied	allege	relieve	allie	aliev	allele	aleve	allee	slieve	alleva	lieve	valliere
circumstances	circumstances
alcoholic	alcoholic
sheet	sheet	chest	cheer	cheek	cheat	chet	cheeta	chee	cheep	cheez
dongle	dongle
ambivalent	ambivalent
library	library
maximum	maximum	maxim	maxum
engine	engine	engines	engin
despair	despair
natural	natural	unnatural
bigginging	bigginging
informally	informally
appresteate	appresteate
dinosaur	dinosaur
minka	minka
integrate	integrate
everthing	everthing	eveything
existance	existance
help	help	hell	hello	hells	hella	helly	helle	hellip
festival	festival
accidently	accidently
quo	quo	quiz	quot	quon	quoi	quoc	quos
favor	favor	favre	fever	famer	saver	faber	laver	waver	fiver	fave	caver	raver	faves	fager	fader	naver	feaver	haver	faler	faker	aver	fazer	xaver	paver	fater
stomach	stomach
easily	easily	basic	basically	basics	basil	busily	vasily	basile	baily	bailly	basili
several	several
sometimes	sometimes
uranium	uranium
exploit	exploit	exploits	expiry
playwrite	playwrite
alchohol	alchohol
inoculate	inoculate
destiny	destiny	destin	destino
initinized	initinized
position	position	division	dilution	distin	diction	dilation	disunion
documtations	documtations
cemetary	cemetary
happily	happily	hazily
cuts	cuts	puts	fits	nuts	outs	fuss	fats	guts	huts	furs	juts	buts	ruts	fouts	fts	uts
intelligent	intelligent	intelident
concensus	concensus
psycolagest	psycolagest
compiler	compiler	comier
mant	mant
paramedic	paramedic	parametric
scrabble	scrabble
initiated	initiated	minimized	digitized	sanitized	initialed	critized
techniques	techniques	technique
belive	belive
psicolagest	psicolagest
reputable	reputable	reusable	removable	reportable	repayable	revocable	opposable	reponsible	responsable	resposible
unentelegible	unentelegible
irritable	irritable
description	description
whip	whip	chimp	whim	whims	wimp	whipp
cooly	cooly
pscolgst	pscolgst
anonymous	anonymous
metaphysical	metaphysical
pronisation	pronisation
development	development
help	help	hip	hop	llp	hmp	lhp	hln	hlf	hla	plp	dlp	hep	hbp	vlp	alp	hls	mlp	clp	hcp	jlp	slp	blp	htp	hap	nlp	hvp	hrp	hpp	elp	ulp	hlb	wlp	hsp	hup	glp	xlp
volunteerism	volunteerism
ennui	ennui
upmost	upmost
anoint	anoint
favor	favor	favre	fever	famer	saver	faber	laver	waver	fiver	fave	caver	raver	faves	fager	fader	naver	feaver	haver	faler	faker	aver	fazer	xaver	paver	fater
marshall	marshall
iphone	iphone	hippie	highline	zipline	sihine	highpine	siphiwe	hipbone
moving	moving	loving	owing	roving	hoving	ving	rving	ovine
ability	ability
factontion	factontion
student	student	sutent
intellegent	intellegent
noted	noted	rolled	polled	noble	bowled	fouled	holed	boiled	nailed	foiled	cooled	nodded	fooled	roiled	doled	pooled	toiled	soiled	oled	howled	nobles	coiled	nozzle	oiled	oozed	dozed	tolled	nosed	nozzles	nolen	nozoe	dolled	nored	tooled	nobler	ogled	nozze	sozzled	notley	nobbled	nolde	lolled	nuzzled	noshed	noles	cozied	soled	foaled	nommed	ozlem	norley	nozad
mosaic	mosaic
rudemtry	rudemtry
helo	helo
dynamic	dynamic
committment	committment	comittee	comitted
brought	brought	bought	sought	fought	rough	drought	ought	wrought	nought	vought	rouget	tought	roughy	roughs
superfluous	superfluous
incomplete	incomplete
congratulations	congratulations
dinosaur	dinosaur	dinajpur
momento	momento
occassion	occassion
parames	parames
knowing	knowing	gnawing
reoccurring	reoccurring
hero	hero	hello	merlo	helo	herro
ast	ast
inital	inital
cuba	cuba	rumba	cuma	zumba	cumbia	kumba	mumba	bumba	dumba
better	better	matter	letter	meter	wetter	mutter	etter	petter	setter	vetter	getter	mette	netter	fetter	mettler	metier	menter	motter	mester	metzer
insistent	insistent
supercede	supercede
embarass	embarass
nieve	nieve
polypropylene	polypropylene
steffen	steffen
perdition	perdition
periodical	periodical	juridical
artic	artic
behavior	behavior
informally	informally
commitee	commitee
embarassment	embarassment
memory	memory	merry	emory	mery	mory
broccoli	broccoli	bocelli
politics	politics	politico	politic
acord	acord
distant	distant	distort
gradually	gradually	gradual
mroe	mroe
teh	teh
anatomy	anatomy
patten	patten
dependable	dependable
simpfilty	simpfilty
permmasivie	permmasivie
euro	euro	error	errol	err	cerro	ergo	eero	ferro	ebro	errs	etro	errr	erno	epro	herro	ero
hippopotamus	hippopotamus
intertek	intertek
misilous	misilous
straightjacket	straightjacket
precious	precious	precis	premios
tommorrow	tommorrow
conscience	conscience
guard	guard	gourd	gard	gaur	gauri	gaura
execution	execution
disagree	disagree
button	button	burton	luton	baton	bouton	buxton	bruton	suton	bunton	futon	butoh	bufton	biton	buon
intelligent	intelligent	intellegent
economy	economy	autonomy	anatomy	annoy	taxonomy	bonomy	agronomy
blair	blair	blast	bait	blatt	blain	blart	plait	lait	blais	blaid
fire	fire	fired	fires	fiery	frey	fairey	airey	filey	furey
situation	situation	saturation	situtation
liquefy	liquefy
aricticure	aricticure
developement	developement
accomodate	accomodate
archetype	archetype
beaurocracy	beaurocracy
want	want	wanat
embed	embed	imbued
failed	failed	fairer	mailer	faller	jailer	filer	sailer	faler	frailer	hailer	failor	faile
specifically	specifically	specificity
hallo	hallo
vinaigrette	vinaigrette
actually	actually	eventually	equally	mutually	ritually
interpreter	interpreter
maks	maks
substations	substations
hifn	hifn	hefin	hifi
discuss	discuss
necessary	necessary	recesses	recessed	nesser
presbyterian	presbyterian
invermeantial	invermeantial
taht	taht
encyclopedia	encyclopedia
unfortunatly	unfortunatly
changing	changing	changeling	changqing	changping	changming
except	except
duren	duren
persue	persue
likely	likely	lilly	lily	likley	likey
crushed	crushed	cruised	crucified	crusted	crusaded
funetik	funetik
infamy	infamy
occupied	occupied
enought	enought
string	string	sterling	steering	staring	storing	tsering	stewing
distract	distract
defense	defense	defence	deeply	defend	evenly	decency	keenly	defends	deftly	denly	decently	deeney	deeny	devenny
satisfy	satisfy	ratify	stifle	stiffly	satiety	satiny	sandfly
